222222222222222222222
200000100000000010002
203330103131101010112
201010001010001010002
203033131010111110102
200000000010000010102
203333301013111011102
201000103000001000002
201013101011311111102
200010001010000000102
211110111010131111102
200010001010001000002
201011101110131011112
201000100010001010002
211110111013101011102
200000101000101000102
201011101011101110102
201010000010001000002
201110111110101011112
200000000000101000002
222222222222222222222 
